17 14 14 14 14 14 14 14 14 14 14 14 14 14 14 14 14 14 14 14 14 14 14 14 14 14 14 14 14 14 14 14 14 14 14 14 14 14 14 14 14 14 14 14 14 14 14 14 14 14 14 14 14 14 14 14 14 14 14 14 14 14 14 14 14 14 14 14 14 14 14 14 14 14 14 14 14 14 14 14 14 14 14 14 14 14 14 14 14 14 14 14 14 14 14 14 14 14 14 14 14 18 
16 5 1 1 1 1 1 1 1 1 1 1 1 1 1 1 1 1 1 1 1 1 1 1 1 1 1 1 1 1 1 1 1 1 1 1 1 1 1 1 1 1 1 1 1 1 1 1 1 1 1 1 1 1 1 1 1 1 1 1 1 1 1 1 1 1 1 1 1 1 1 1 1 1 1 1 1 1 1 1 1 1 1 1 1 1 1 1 1 1 1 1 1 1 1 1 1 1 1 1 6 16
16 3 10 10 0 0 0 10 0 13 10 0 0 0 9 0 13 0 0 9 13 10 9 0 13 0 0 12 0 11 0 0 0 10 0 0 0 0 0 0 0 11 0 9 0 0 0 0 0 0 9 0 10 9 0 0 0 0 9 0 0 12 0 9 9 9 0 9 10 0 0 9 0 0 11 9 0 0 0 10 0 0 10 10 10 0 0 9 0 10 10 10 0 0 10 10 0 9 0 0 4 16 
16 3 0 0 9 13 0 0 9 9 0 0 10 12 0 0 0 10 0 9 0 0 9 10 10 0 9 10 10 9 13 0 12 0 0 0 0 0 0 12 10 10 10 11 10 9 0 9 10 9 0 0 9 9 11 0 0 9 10 9 0 9 0 10 9 0 0 9 9 0 0 0 0 0 0 0 10 10 0 0 0 0 0 10 0 0 9 0 0 0 10 9 10 0 0 9 0 0 0 0 4 16 
16 3 9 0 0 0 10 9 0 11 10 10 0 9 10 0 9 9 10 9 10 10 0 0 10 9 0 10 0 9 9 0 9 9 0 10 0 10 0 0 0 0 0 13 0 0 0 0 10 10 0 12 10 0 10 0 10 9 0 0 10 0 10 9 0 10 10 10 0 9 12 10 10 10 0 9 0 0 0 0 13 0 13 9 0 0 0 13 9 0 9 12 0 0 0 0 0 0 10 0 4 16 
16 3 9 13 10 10 0 10 0 13 9 0 10 10 10 0 0 0 9 9 0 10 10 9 9 0 9 0 9 10 10 0 0 10 0 9 0 0 0 9 0 9 10 0 0 9 0 0 0 9 0 9 9 0 0 9 10 10 0 10 10 0 0 0 0 11 0 0 11 9 13 0 10 10 10 0 0 0 10 10 9 10 9 10 0 10 0 0 9 0 10 10 9 0 0 0 9 11 0 0 4 16 
16 3 9 0 9 0 9 0 0 10 10 10 0 9 9 9 0 0 0 0 0 0 0 0 9 9 10 0 13 10 0 0 10 0 0 10 10 11 0 0 0 0 10 0 0 9 11 10 10 10 0 9 0 0 0 0 10 9 10 10 9 10 9 10 9 0 0 0 0 9 0 9 9 10 0 0 10 9 10 9 0 0 0 0 0 0 10 9 0 10 10 10 0 9 9 10 9 0 0 0 4 16 
16 3 9 0 10 10 0 10 10 10 0 10 10 9 0 10 0 10 0 0 10 0 0 10 0 0 10 0 0 10 9 13 0 10 10 0 0 0 0 0 10 0 11 0 0 9 9 10 9 10 0 0 9 12 0 10 10 0 0 10 9 0 0 9 10 0 10 10 10 10 9 9 10 9 0 10 0 0 0 9 0 9 0 0 0 0 0 9 10 0 10 13 9 0 0 9 9 0 9 0 4 16 
16 3 10 0 10 10 0 12 0 0 10 0 0 9 0 10 10 0 0 10 0 0 10 9 10 10 12 0 10 9 9 0 13 0 0 10 9 10 0 9 10 0 0 11 0 0 0 13 0 0 0 10 10 0 9 9 0 11 0 10 9 0 10 0 0 0 0 0 0 0 0 0 9 10 0 0 0 9 0 10 12 10 10 0 10 10 0 0 9 0 0 0 0 0 0 0 11 9 10 11 4 16 
16 3 9 0 0 0 0 10 10 11 0 0 10 0 0 9 9 0 10 9 0 0 10 9 0 13 0 0 13 10 0 0 10 13 0 10 10 0 0 0 0 0 0 0 0 10 13 0 0 10 11 0 9 0 0 0 10 0 0 9 0 0 10 10 10 0 10 0 9 10 10 10 9 0 0 0 0 9 9 9 9 9 0 0 0 0 0 0 9 0 9 10 9 9 0 0 9 10 10 0 4 16 
16 3 10 0 10 0 10 9 9 0 0 10 0 9 9 0 13 10 12 10 10 9 0 9 0 10 0 9 10 10 0 10 0 13 0 13 10 0 9 11 9 9 10 0 10 10 0 0 0 0 0 0 10 9 0 11 9 9 9 0 0 0 9 0 9 9 10 0 13 0 9 9 0 0 0 10 0 0 0 0 9 10 0 0 9 0 10 11 10 9 10 0 0 10 0 0 0 0 0 10 4 16 
16 3 0 0 0 10 0 0 0 9 0 9 10 10 0 0 9 9 0 0 10 9 10 10 0 0 10 0 9 0 10 10 0 13 10 12 10 9 9 10 9 0 0 9 0 10 0 9 0 10 0 0 0 10 11 0 0 9 12 10 0 12 0 10 9 0 10 0 0 9 10 0 13 0 9 11 0 0 0 0 0 13 0 0 10 0 10 10 9 13 9 9 10 0 9 9 12 9 0 0 4 16 
16 3 10 9 0 10 0 9 10 0 0 9 9 0 0 9 0 0 9 9 0 0 0 0 0 0 10 0 11 9 10 9 0 0 9 9 0 9 9 9 9 10 10 11 0 0 9 0 11 0 10 11 0 0 0 0 0 10 0 10 10 0 0 13 0 0 0 0 10 0 0 12 0 10 0 0 9 0 10 9 10 9 12 0 10 10 10 0 0 11 0 10 10 0 10 0 0 0 0 0 4 16 
16 3 9 0 9 10 0 10 12 0 9 0 10 9 0 0 0 0 0 9 0 0 0 0 10 0 10 13 0 0 9 10 10 0 0 0 0 0 0 9 9 0 9 0 10 12 0 0 9 9 10 0 0 0 0 10 10 13 9 10 0 0 0 0 0 0 0 0 0 0 0 0 0 9 10 10 0 10 0 10 10 0 10 0 0 9 0 10 10 0 0 0 9 0 0 9 0 9 0 0 4 16 
16 3 10 0 9 10 0 0 10 10 9 0 0 0 12 0 0 10 9 0 10 10 10 0 0 10 0 0 10 0 0 0 10 0 10 0 0 10 9 0 0 0 9 9 9 0 0 9 0 0 0 0 9 0 0 10 10 0 0 0 9 0 0 9 0 0 10 10 0 9 12 0 9 0 9 0 9 0 0 9 9 0 10 0 10 10 0 9 10 0 0 9 0 0 0 0 9 0 11 0 4 16 
16 3 0 10 0 9 0 0 0 9 0 10 10 0 0 0 0 10 10 0 0 0 10 10 10 0 10 0 0 9 10 0 0 0 0 10 0 9 10 0 0 0 0 0 0 0 0 10 9 0 0 0 0 10 9 9 0 0 0 9 0 0 0 10 9 9 0 0 10 9 10 0 0 9 0 10 10 0 0 0 13 0 10 10 0 0 11 10 9 10 9 0 0 10 0 12 9 0 0 0 4 16 
16 3 0 0 9 10 0 0 10 0 10 9 10 0 0 10 0 0 0 0 9 0 9 0 10 9 9 0 10 10 10 10 9 10 0 9 0 9 10 0 0 0 9 0 10 9 0 0 0 10 0 0 10 0 0 0 13 9 0 9 10 11 0 9 9 10 0 0 10 9 9 0 10 0 9 12 9 0 0 10 10 10 9 0 0 0 10 9 0 9 0 9 0 0 0 9 9 11 0 0 4 16 
16 3 0 0 10 0 0 0 0 12 9 0 10 10 0 0 10 10 0 11 9 10 0 10 0 9 0 9 13 0 13 0 10 0 0 10 10 0 9 9 0 0 0 9 0 0 0 0 9 0 10 9 9 0 0 0 10 10 0 0 9 9 10 0 9 0 0 10 0 9 10 0 9 9 0 0 0 9 12 0 9 10 0 0 10 0 0 0 0 13 10 0 9 9 10 9 0 0 0 10 4 16 
16 3 0 0 0 9 9 9 9 0 0 13 9 0 12 9 0 0 10 10 0 0 0 11 0 10 9 0 0 0 10 0 10 0 9 10 10 10 0 9 0 12 0 0 0 9 0 0 0 0 10 0 0 0 11 0 0 0 9 0 0 13 0 0 10 9 9 12 0 10 0 0 10 10 11 0 12 0 10 12 0 0 0 0 0 0 0 10 0 12 0 0 13 9 0 0 0 0 0 0 4 16 
16 3 0 13 0 0 9 9 0 0 10 0 10 0 0 0 10 12 10 10 0 11 0 0 0 0 0 0 9 10 10 0 0 9 0 0 10 0 9 9 13 0 0 0 0 0 9 0 10 10 0 11 9 10 10 9 0 0 0 13 0 10 9 10 0 10 13 10 0 0 0 9 10 9 13 9 9 0 0 0 9 0 10 9 0 0 13 10 13 0 9 0 0 12 9 0 10 0 0 0 4 16 
16 3 9 0 10 9 0 11 0 0 9 10 12 9 0 0 0 0 10 0 0 12 0 10 0 0 0 0 9 9 0 13 10 10 0 13 0 10 9 9 0 0 0 12 0 12 10 0 0 11 9 0 0 0 0 9 0 0 9 10 0 10 0 11 10 10 10 10 9 0 9 0 10 0 0 0 11 10 0 0 10 0 10 10 0 0 0 11 0 0 0 12 0 0 9 0 0 9 9 9 4 16 
16 3 0 0 10 0 11 9 0 9 0 10 9 12 10 0 10 0 0 0 0 0 0 0 9 0 9 9 0 0 9 9 10 13 0 10 0 12 0 0 10 9 0 9 10 0 9 10 10 9 0 10 10 0 0 0 10 0 0 9 9 9 0 9 0 12 9 10 0 10 10 12 0 0 9 9 10 0 12 10 10 0 0 0 0 0 0 0 0 0 0 9 0 9 9 0 0 0 0 0 4 16 
16 3 0 0 0 0 0 0 10 9 0 0 9 9 0 9 0 0 0 0 0 0 0 0 0 10 0 9 10 10 0 0 0 10 0 10 10 0 10 0 0 9 0 0 11 9 0 9 0 0 9 9 10 0 0 13 0 0 0 11 0 0 0 13 0 0 10 0 0 9 10 0 9 9 10 10 0 11 0 0 9 10 9 10 11 10 10 0 0 0 10 0 0 0 10 10 0 10 0 0 4 16 
16 3 10 10 0 9 9 0 10 0 0 0 0 0 0 0 9 9 0 0 0 13 10 0 0 0 9 0 0 10 0 10 9 10 0 10 0 10 0 9 0 0 0 0 10 10 0 10 0 0 13 0 0 0 0 9 0 9 0 0 0 10 0 10 10 9 10 0 0 11 9 0 9 0 13 0 0 10 0 10 0 9 0 0 0 0 10 10 12 0 0 10 9 10 13 9 9 0 0 11 4 16 
16 3 0 0 9 0 0 0 0 9 0 9 0 0 0 0 0 0 0 0 0 0 0 13 0 9 9 10 0 0 0 0 13 10 9 10 9 0 10 0 10 9 10 9 10 10 9 0 0 0 0 0 10 0 0 10 0 9 10 0 0 9 0 9 12 0 0 10 10 11 10 9 0 9 9 9 10 13 0 9 0 9 0 10 9 13 0 9 0 10 0 13 0 10 10 0 0 13 0 0 4 16 
16 3 0 0 0 9 9 0 0 9 0 9 0 0 0 10 0 10 9 10 9 10 0 0 0 0 0 10 12 0 9 0 0 9 0 0 13 0 0 11 0 0 0 11 9 0 0 0 10 10 0 0 0 10 0 11 0 0 12 0 10 10 0 10 10 0 10 10 0 0 10 9 0 0 0 0 9 9 0 0 0 9 0 9 0 0 9 0 0 9 9 10 0 9 9 0 0 0 0 10 4 16 
16 3 0 0 9 0 0 12 0 0 0 12 0 0 0 0 10 9 0 11 10 12 0 10 0 10 9 0 0 0 9 9 10 11 10 9 10 11 9 9 0 10 12 0 0 12 9 0 10 10 0 9 9 10 10 10 10 10 0 0 10 9 0 12 0 0 0 0 10 10 0 13 0 0 10 0 0 0 0 10 0 10 0 9 0 9 10 0 0 0 9 9 9 9 0 9 9 10 9 13 4 16 
16 3 9 12 0 0 0 9 11 10 11 0 10 0 10 0 10 10 0 0 0 0 11 0 0 0 9 10 0 11 10 10 0 0 0 9 0 0 13 10 0 11 9 0 0 13 0 9 0 0 9 0 0 10 0 0 11 10 0 12 0 0 10 0 10 13 0 0 9 0 10 0 0 9 0 10 0 0 0 0 0 11 0 13 0 11 9 9 0 0 0 0 0 0 9 0 0 0 0 0 4 16 
16 3 0 0 10 0 10 10 0 10 10 9 10 0 0 9 0 0 10 12 0 13 0 0 0 10 0 0 13 9 0 9 9 10 0 9 0 0 0 0 0 0 10 0 9 0 9 0 10 9 13 0 10 0 0 10 0 0 0 9 0 10 0 0 11 0 0 0 9 10 0 0 0 0 10 0 11 0 0 9 0 10 0 10 0 0 0 0 0 10 9 10 0 0 0 10 0 0 10 0 4 16 
16 3 9 12 0 0 13 0 0 0 0 0 0 0 9 10 10 9 9 0 9 9 9 0 0 0 0 0 9 10 10 10 0 0 10 9 0 9 9 0 0 9 9 9 0 9 9 12 0 0 10 0 10 10 0 0 13 10 10 0 0 9 0 0 0 0 0 0 10 10 10 0 0 9 0 12 0 0 0 0 10 0 0 9 10 0 12 0 11 0 9 9 0 0 9 0 9 0 10 10 4 16 
16 3 9 9 0 10 0 9 0 0 12 0 0 10 0 10 0 9 0 10 10 10 0 11 0 10 10 9 0 9 9 10 0 0 0 12 0 0 10 9 9 0 0 0 0 9 13 0 10 12 0 0 10 9 0 10 9 9 0 9 10 9 9 0 9 10 0 12 0 10 9 9 10 11 0 9 9 0 0 13 10 10 9 0 0 0 9 0 12 9 10 0 11 0 10 0 0 9 0 0 4 16 
16 3 13 0 0 0 12 10 10 10 10 0 0 11 0 0 0 0 9 0 0 0 9 0 9 0 9 0 0 0 9 0 11 0 0 0 10 0 0 0 0 9 9 10 0 0 9 11 10 9 0 0 9 0 10 0 9 0 0 0 10 0 0 0 9 0 0 9 0 12 0 0 0 0 0 10 10 10 9 0 10 0 12 0 9 9 0 0 0 12 0 0 0 0 0 0 9 11 9 0 4 16 
16 3 12 0 0 0 10 9 0 0 9 0 0 0 0 9 0 11 0 12 0 0 0 9 13 10 0 0 0 0 9 9 0 0 0 9 0 0 10 0 0 10 9 10 0 0 9 0 9 0 9 10 10 0 10 0 0 12 10 0 0 0 9 10 0 0 10 0 0 0 10 10 0 0 0 0 13 9 0 0 0 0 0 0 0 0 10 0 9 0 9 10 0 10 0 0 11 10 0 11 4 16 
16 3 0 9 9 0 9 12 9 0 9 0 9 0 0 0 10 10 9 12 0 0 13 10 0 0 9 0 10 10 0 10 0 0 0 0 9 0 0 0 0 9 0 9 9 10 10 0 0 11 10 9 0 0 0 0 9 11 9 10 10 9 0 9 9 9 12 0 10 0 10 0 0 10 0 10 0 0 0 0 10 10 0 0 0 9 10 12 0 0 0 10 0 0 9 0 9 9 9 9 4 16 
16 3 0 9 0 0 9 0 12 0 0 0 11 9 9 9 0 9 0 0 0 10 0 0 9 9 10 10 9 0 10 9 0 0 9 0 10 0 9 9 9 10 0 0 0 12 9 10 10 10 0 9 0 0 9 9 0 10 0 9 9 0 0 0 0 9 9 11 0 9 10 0 0 11 0 0 0 0 0 10 9 0 0 10 9 9 9 0 0 0 0 0 10 0 0 9 9 0 10 0 4 16 
16 3 10 13 0 0 0 0 10 9 0 0 0 10 11 0 0 10 0 0 9 0 0 10 0 10 13 9 0 9 10 0 0 10 0 10 12 0 0 0 0 0 0 0 10 9 9 0 0 0 0 9 11 0 9 0 10 9 0 10 0 0 10 0 10 0 0 11 0 12 0 0 0 0 10 0 0 9 0 9 9 10 0 9 9 0 0 9 9 0 0 0 0 10 9 0 0 9 0 9 4 16 
16 3 0 0 0 0 10 0 0 9 0 9 0 10 0 13 0 0 0 9 12 10 10 0 0 10 0 10 10 0 0 10 10 13 9 0 10 0 0 0 10 11 9 10 0 0 0 9 9 9 0 0 0 10 10 0 9 0 0 9 0 9 9 9 10 0 0 0 0 10 10 9 0 0 0 0 10 0 0 9 10 13 9 9 0 0 0 10 10 13 10 0 0 0 9 0 10 9 10 10 4 16 
16 3 0 0 10 9 13 0 12 0 0 0 9 0 0 0 9 0 0 0 0 10 0 10 10 0 9 0 0 0 9 10 0 0 0 0 0 0 0 0 0 11 9 0 9 10 0 0 9 9 0 9 9 9 0 0 0 0 0 9 10 0 0 0 0 0 0 9 0 0 0 0 0 9 0 10 0 12 9 9 0 0 0 0 0 0 9 10 9 10 9 11 0 0 10 0 0 0 0 9 4 16 
16 3 12 10 0 10 0 0 0 0 10 10 9 11 9 0 10 0 0 9 0 0 10 0 10 0 9 9 0 9 9 0 0 9 0 0 9 9 0 10 11 9 9 12 0 10 10 0 9 0 0 10 0 10 0 10 10 0 0 10 0 0 9 9 0 0 0 9 0 0 0 9 0 0 10 0 9 10 0 11 9 0 10 10 0 0 0 10 10 9 0 10 0 0 9 0 0 0 0 0 4 16 
16 3 0 13 9 11 9 9 10 0 9 0 10 0 9 10 9 0 9 0 10 0 0 9 12 0 0 0 0 9 0 9 10 9 13 0 0 0 10 9 10 0 9 0 0 0 9 0 9 0 9 11 0 9 10 0 13 9 0 10 10 0 11 0 0 10 0 0 12 0 0 10 9 0 0 9 0 9 12 0 10 0 13 10 10 10 11 10 0 0 10 0 0 10 0 10 9 0 10 9 4 16 
16 3 0 0 0 10 0 10 0 0 0 0 10 10 0 10 0 12 0 9 0 0 0 10 12 9 0 9 9 0 10 10 0 0 0 13 9 12 0 9 10 9 0 0 10 9 9 9 10 9 0 0 13 0 0 0 0 0 0 10 0 13 0 0 0 10 0 10 0 9 11 9 0 0 0 10 10 10 0 0 9 0 0 13 0 0 10 10 10 10 10 9 0 0 0 10 0 0 0 10 4 16 
16 3 10 0 0 0 9 9 9 0 10 9 0 0 0 9 10 0 0 10 0 11 10 9 0 0 9 0 12 0 11 10 0 9 0 0 0 10 9 10 9 0 0 9 9 0 0 0 9 0 0 9 10 13 10 9 0 0 0 12 0 13 0 10 0 9 0 10 0 0 0 11 9 0 0 0 10 10 0 0 0 0 0 0 9 0 0 9 0 0 0 11 0 10 0 0 0 10 9 10 4 16 
16 3 0 11 0 10 0 0 0 0 10 0 10 0 0 0 0 9 9 0 0 9 0 0 10 13 0 13 0 10 0 10 9 0 10 0 0 0 9 0 9 11 0 9 0 0 0 10 0 10 0 0 0 0 10 0 0 0 0 0 0 9 9 10 10 9 12 0 0 9 0 10 0 9 10 9 0 0 0 0 0 9 13 10 0 10 0 9 11 0 9 0 9 0 0 9 11 0 10 0 4 16 
16 3 10 10 0 9 9 0 0 10 10 10 12 0 0 0 10 0 10 0 9 10 9 10 0 9 9 10 9 9 0 10 0 9 0 0 9 0 0 9 10 9 10 9 0 0 0 0 12 0 0 0 13 10 0 0 10 0 10 0 10 0 10 13 0 0 0 10 9 9 10 0 0 10 0 10 10 9 10 0 0 9 9 9 10 9 0 9 0 10 0 9 9 10 0 0 10 0 0 10 4 16 
16 3 9 0 0 0 0 0 0 0 0 0 10 0 0 9 10 0 0 9 10 0 0 0 0 0 10 0 0 0 0 0 0 0 0 9 9 0 0 0 0 10 0 9 9 12 10 0 9 0 9 0 10 0 0 9 10 13 0 0 9 0 0 13 9 13 0 0 10 10 12 0 0 0 0 10 9 10 0 0 0 9 0 0 10 10 10 0 0 0 10 11 0 11 9 0 11 0 0 9 4 16 
16 3 0 13 0 10 10 0 9 10 9 9 0 10 0 10 10 0 0 0 0 10 0 0 9 0 9 0 10 0 0 0 0 0 0 13 9 12 10 10 9 0 11 10 0 0 0 0 0 10 0 0 12 9 0 9 0 0 0 10 10 10 0 10 0 10 0 9 9 0 0 0 0 9 10 0 0 0 12 9 0 0 0 0 0 10 0 0 9 10 10 0 0 9 0 0 0 10 0 10 4 16 
16 3 0 0 0 9 0 0 0 10 0 9 0 10 0 0 0 9 0 10 0 0 9 0 0 11 0 0 0 9 9 0 0 0 10 10 0 0 0 0 0 9 10 10 13 0 9 0 12 0 9 9 11 9 0 0 0 10 0 9 9 0 11 0 0 9 9 10 0 0 10 10 0 10 0 0 9 0 0 9 0 0 0 0 0 10 0 10 0 0 0 0 10 10 10 0 9 0 0 0 4 16 
16 3 9 10 0 0 0 0 0 10 0 10 9 0 9 9 0 0 0 0 0 13 0 0 0 0 0 0 10 0 0 0 9 0 0 10 0 0 9 9 0 0 10 10 11 9 9 0 0 11 0 0 10 0 0 10 9 13 0 11 0 11 9 10 0 10 0 9 0 11 9 0 0 10 0 0 9 10 10 0 10 0 0 13 9 9 0 9 10 9 9 0 9 13 0 9 0 12 9 12 4 16 
16 3 0 9 0 0 0 0 0 0 9 10 9 10 0 9 10 10 10 12 9 0 9 0 9 9 9 0 0 9 0 0 10 11 9 9 0 0 13 10 11 0 0 0 0 10 0 0 0 10 9 0 0 0 0 0 9 9 0 10 11 10 0 9 9 10 9 12 9 0 0 9 13 10 0 10 9 0 0 10 0 10 9 0 0 10 9 9 10 9 9 10 13 0 0 0 10 0 9 0 4 16 
16 3 0 10 0 9 0 9 0 0 0 9 9 9 9 11 0 10 10 13 0 0 0 0 0 0 0 0 12 10 0 0 0 9 10 0 0 9 0 9 0 10 0 0 0 9 0 0 0 0 9 0 0 0 0 0 9 10 9 0 10 10 0 0 9 10 9 10 0 0 10 0 0 0 9 0 0 11 0 0 0 0 10 9 10 0 9 11 0 9 9 0 0 0 0 0 0 10 0 0 4 16 
16 3 0 0 0 0 10 0 0 0 0 9 9 9 0 0 9 0 0 9 10 0 0 9 0 10 10 0 9 0 11 9 10 0 0 0 10 10 0 0 10 9 0 9 0 0 9 0 10 0 9 9 0 10 10 0 0 11 0 10 0 13 9 10 9 9 9 10 12 0 0 11 9 9 13 10 9 10 0 0 0 0 10 10 0 0 10 0 9 10 0 10 9 10 10 0 10 0 0 0 4 16 
16 3 9 0 0 0 0 10 0 0 0 0 9 0 0 0 0 9 10 0 13 0 10 0 11 9 0 0 0 0 9 9 13 0 0 9 0 10 10 0 0 0 0 0 10 0 0 10 9 0 12 10 0 13 10 0 0 0 11 0 0 0 0 0 0 0 9 0 0 0 0 9 0 13 0 9 0 0 9 0 9 12 0 0 0 0 0 0 0 9 0 0 0 9 9 9 0 9 11 0 4 16 
16 3 0 0 10 9 10 0 0 0 0 10 0 10 9 9 10 0 0 0 10 9 0 0 9 0 13 0 10 0 9 0 9 0 10 9 9 0 0 10 9 0 9 0 10 9 0 0 10 10 0 0 10 0 9 0 0 0 9 0 0 10 0 0 10 0 9 0 10 0 0 9 10 0 0 0 0 0 0 0 13 0 0 0 10 9 0 10 0 9 0 0 9 10 0 0 0 9 0 13 4 16 
16 3 0 0 9 10 9 9 0 0 0 10 0 0 9 0 0 0 11 9 0 13 9 9 0 0 0 0 0 10 13 9 9 9 0 0 9 0 0 12 10 9 0 0 0 0 0 10 10 0 0 0 0 0 9 9 0 9 10 12 9 0 10 9 0 0 0 13 0 9 0 12 0 12 0 10 0 9 9 0 0 9 0 0 10 0 10 0 10 0 0 0 10 10 10 10 0 12 0 13 4 16 
16 3 0 10 0 10 13 9 10 0 11 9 9 0 9 10 10 0 0 10 10 10 0 12 9 0 0 0 0 0 0 0 10 9 0 10 11 10 0 0 9 0 0 0 10 11 0 10 10 0 0 13 0 10 0 9 0 9 10 9 9 0 9 0 12 9 0 0 10 10 9 0 0 9 9 0 10 0 10 10 13 10 0 0 0 0 10 9 0 13 10 9 0 9 0 10 0 0 12 0 4 16 
16 3 13 9 0 0 9 0 0 9 0 9 0 12 0 9 10 0 9 0 0 10 0 9 0 0 0 0 13 0 10 0 0 9 9 12 0 9 10 0 9 0 10 9 0 10 0 0 10 0 9 9 9 0 0 0 0 9 9 10 0 0 0 12 0 0 10 0 0 9 9 0 0 10 10 9 0 9 0 10 0 0 0 10 9 9 9 9 9 0 9 0 9 0 10 10 0 0 12 10 4 16 
16 3 0 9 9 9 0 10 11 10 10 11 0 0 10 10 9 10 0 0 9 0 9 10 9 0 11 0 9 10 0 0 0 0 0 10 0 0 0 0 9 12 10 10 10 10 9 0 0 10 10 0 0 0 0 10 13 0 10 0 0 10 13 0 9 13 0 11 0 9 9 0 0 9 0 0 0 0 0 0 0 0 9 0 0 9 12 0 9 0 0 9 10 0 9 9 9 0 0 0 4 16 
16 3 0 10 0 0 0 10 0 0 0 10 0 0 13 0 10 9 9 12 0 0 10 0 0 10 0 10 0 0 0 13 9 13 0 11 0 0 9 0 10 10 0 10 9 0 0 13 10 0 0 0 0 10 10 10 0 0 10 0 0 0 0 10 0 10 0 0 13 9 10 9 9 0 0 10 12 0 0 0 11 10 10 12 0 0 9 0 0 0 10 9 0 0 10 0 9 10 0 10 4 16 
16 3 9 10 0 11 0 0 10 9 12 10 0 0 0 10 10 10 10 9 0 10 0 13 0 0 13 10 0 9 0 11 9 9 11 0 0 10 13 9 13 0 0 9 0 0 10 10 0 9 10 0 9 0 10 0 0 0 0 0 9 0 10 0 10 10 9 0 9 10 10 10 9 9 0 0 0 0 12 0 0 12 10 9 10 0 10 0 9 10 9 0 12 9 0 9 0 10 9 0 4 16 
16 3 9 9 12 9 0 0 10 0 10 0 0 9 0 0 9 0 0 0 10 0 0 10 9 12 9 0 9 10 0 10 10 0 0 0 0 0 0 9 0 12 0 0 0 0 10 12 0 0 0 0 12 9 0 11 0 0 9 0 0 0 10 0 9 9 0 9 10 10 0 0 9 10 0 0 10 9 9 11 10 0 10 9 0 9 0 10 9 0 10 0 0 0 0 10 0 10 0 10 4 16 
16 3 10 0 0 9 0 0 9 0 0 0 11 0 0 0 0 10 0 0 13 0 9 9 10 0 0 0 0 11 0 10 0 0 9 0 0 0 0 0 0 9 9 10 10 10 10 9 10 10 0 0 9 10 9 0 12 0 0 0 0 0 0 10 0 0 0 10 9 0 10 0 0 0 0 10 0 10 10 10 10 9 0 0 0 9 10 9 0 11 9 13 0 0 10 0 0 0 0 0 4 16 
16 3 10 11 0 0 9 10 0 0 0 10 10 0 10 9 0 10 9 0 0 10 0 0 0 12 0 10 9 0 0 9 9 10 0 10 0 11 10 9 10 0 0 0 11 10 10 0 9 9 12 9 10 0 9 0 0 0 9 13 0 10 10 9 13 9 9 10 10 9 0 9 0 9 10 9 0 0 0 0 9 10 11 10 0 12 9 10 11 10 0 0 0 12 9 0 10 0 0 0 4 16 
16 3 10 9 0 0 9 9 9 10 11 9 0 0 9 0 0 0 10 0 0 9 0 10 0 0 10 0 0 10 0 10 0 10 0 0 0 10 9 0 9 9 11 10 0 10 0 0 13 0 0 0 0 0 9 0 0 9 0 0 0 0 0 10 0 0 0 0 0 0 9 9 10 0 0 0 0 0 0 12 9 10 0 10 0 10 0 0 10 11 0 11 9 0 0 9 0 10 9 0 4 16 
16 3 0 0 9 10 0 0 0 0 0 9 0 9 0 13 0 0 0 0 0 9 10 0 0 10 0 10 12 0 0 11 9 0 0 0 0 0 0 11 9 13 0 10 0 0 10 0 11 9 10 9 9 0 0 13 0 0 0 13 0 10 11 0 0 9 0 0 9 9 0 10 9 0 0 9 10 9 10 9 0 0 12 0 0 9 11 9 0 0 0 0 12 0 13 0 10 10 9 12 4 16 
16 3 0 13 0 0 9 0 0 11 0 0 0 10 10 0 12 0 9 9 0 9 9 9 10 0 10 0 0 10 10 0 9 10 0 12 0 10 0 9 9 0 9 9 10 0 0 10 0 0 0 9 9 10 0 9 10 10 0 0 0 0 0 9 0 9 0 9 10 0 0 9 0 0 9 0 0 0 10 10 9 0 9 0 0 10 0 9 0 10 0 0 0 10 0 0 9 0 9 0 4 16 
16 3 0 0 9 0 0 0 9 0 0 9 10 9 10 0 0 9 0 0 12 0 0 9 10 10 0 12 0 0 0 0 9 0 0 9 0 0 0 9 0 9 9 0 0 10 10 0 0 0 10 0 10 10 10 0 0 0 0 0 9 0 0 9 10 0 10 0 0 0 0 0 0 10 0 10 0 10 0 0 9 10 0 0 0 0 11 10 0 0 0 9 10 12 9 10 10 0 0 10 4 16 
16 3 0 11 9 10 0 11 10 0 9 10 10 11 0 0 10 9 0 9 11 0 9 0 0 0 0 0 0 11 0 9 10 9 9 10 0 9 0 9 0 0 0 0 10 10 0 9 9 9 10 0 0 0 11 0 0 12 9 10 9 0 10 0 9 0 0 10 0 9 0 9 0 0 0 0 0 10 0 0 10 0 10 0 0 0 0 10 9 10 10 13 9 0 0 0 9 0 0 0 4 16 
16 3 9 13 0 0 9 0 0 0 11 0 9 9 0 12 0 12 0 0 0 0 10 10 0 0 9 11 0 12 0 0 0 12 9 10 10 9 10 0 0 0 9 0 0 0 0 12 0 9 10 11 0 0 0 10 12 9 0 0 12 9 0 0 0 0 10 0 9 9 0 0 9 0 9 0 9 10 0 0 0 0 13 0 9 0 10 0 11 10 0 10 10 9 0 0 0 10 10 0 4 16 
16 3 0 0 0 0 10 0 0 13 0 10 12 0 10 9 0 0 9 0 10 0 0 9 0 0 0 9 10 9 0 0 10 9 0 0 10 10 0 10 0 12 10 0 9 0 10 10 10 0 9 9 10 10 9 9 10 0 11 9 0 0 0 0 10 0 11 0 9 0 10 10 9 0 10 9 13 9 10 13 10 13 0 10 10 0 10 0 9 0 10 9 0 0 10 0 0 0 10 10 4 16 
16 3 0 0 12 10 0 9 0 10 10 10 0 0 10 10 0 0 0 0 9 0 0 0 0 9 0 11 9 9 0 0 9 10 10 0 0 0 13 0 0 9 0 0 9 10 0 12 0 0 10 0 12 10 9 0 0 10 0 0 9 0 9 12 0 0 0 0 10 0 0 0 0 0 0 0 10 0 0 12 0 0 0 13 10 12 10 0 0 0 0 0 0 0 0 9 9 0 0 10 4 16 
16 3 0 10 9 0 11 9 10 0 0 11 0 0 0 10 9 0 0 0 9 0 10 10 9 10 0 0 9 9 0 11 0 0 10 0 9 0 9 0 13 9 0 0 0 0 9 9 0 9 9 13 0 0 0 0 11 9 10 9 10 9 0 11 0 10 0 9 0 13 0 0 0 11 0 0 0 10 10 0 0 9 12 0 0 10 10 13 9 9 10 10 0 10 0 9 10 9 0 0 4 16 
16 3 9 0 10 10 10 9 0 0 9 0 9 0 11 10 12 0 10 10 10 13 0 0 0 0 0 0 0 9 0 10 0 9 0 0 9 10 10 11 10 0 0 9 9 0 13 0 0 12 0 10 0 10 0 0 0 9 13 0 10 9 9 0 0 12 9 0 10 10 0 0 0 12 0 10 0 10 10 10 10 0 9 9 9 10 0 10 10 0 0 0 12 0 9 0 10 0 10 0 4 16 
16 3 13 0 0 9 0 9 10 9 0 0 9 0 0 0 10 0 0 0 10 9 0 10 0 0 9 10 0 0 9 0 0 11 0 10 0 9 0 10 10 10 9 10 9 0 0 0 9 10 9 0 0 10 9 9 0 0 9 0 0 10 0 9 0 0 0 9 0 0 10 0 10 0 9 9 10 0 12 0 0 9 0 9 0 9 9 12 0 0 0 0 0 0 0 9 0 0 0 10 4 16 
16 3 10 9 10 9 9 10 0 9 9 0 9 0 0 10 10 9 0 0 0 9 9 10 0 9 0 9 11 10 0 0 0 0 9 0 10 0 10 0 9 10 0 0 0 0 0 0 9 10 10 0 0 10 0 9 9 9 10 9 9 0 0 0 0 9 12 0 11 0 0 0 0 9 10 0 0 0 12 0 10 0 0 0 10 0 10 9 0 0 10 10 9 9 9 10 10 9 0 9 4 16 
16 3 9 0 0 0 0 9 10 0 10 10 0 10 0 0 9 9 11 10 0 0 9 9 11 9 0 0 10 0 0 0 0 9 10 11 10 9 0 9 0 0 10 10 0 0 12 0 0 9 0 9 9 0 10 0 0 0 0 10 10 0 0 0 11 0 0 0 0 10 13 9 9 10 0 10 0 9 0 9 0 9 0 0 9 0 10 11 9 0 9 10 10 9 0 10 0 0 0 10 4 16 
16 3 10 0 10 9 0 0 0 0 0 0 10 9 9 0 0 13 0 0 9 0 0 9 0 0 0 11 9 0 9 11 10 9 0 9 9 0 0 9 0 0 0 0 0 0 0 0 0 10 12 0 0 0 0 11 10 10 0 10 9 0 12 0 0 0 10 0 9 0 9 0 0 9 0 9 10 9 9 0 0 0 0 9 0 0 0 0 9 0 10 0 11 0 10 13 0 0 9 0 4 16 
16 3 0 0 0 0 9 10 0 10 0 0 0 9 10 0 9 10 11 10 9 9 0 0 9 0 12 0 10 9 0 0 10 0 0 0 0 11 0 0 0 0 0 9 0 10 0 0 9 0 0 0 0 9 10 10 10 10 9 9 9 9 0 10 9 9 0 0 9 10 10 0 9 10 10 0 0 0 0 9 0 0 9 9 9 0 0 10 9 0 10 12 10 11 9 9 0 10 9 9 4 16 
16 3 10 10 9 10 9 0 10 13 9 0 10 10 0 0 10 10 10 9 10 0 0 12 10 0 0 0 0 9 9 0 0 0 0 0 0 10 0 11 10 10 0 10 10 11 10 0 9 13 0 0 10 10 0 13 0 10 9 0 9 10 10 11 10 9 10 9 9 0 9 0 0 9 0 0 0 9 10 9 0 10 9 9 0 10 0 0 0 0 10 10 9 10 12 0 10 9 0 9 4 16 
16 3 0 0 0 0 10 10 0 0 0 10 13 0 0 0 0 12 10 10 9 10 0 9 0 9 10 0 9 10 0 0 10 10 0 0 9 10 0 9 0 10 13 0 0 0 0 0 0 13 10 0 10 10 0 10 0 9 10 0 0 0 12 10 10 10 13 0 0 9 0 13 9 13 0 0 0 0 0 0 0 9 0 0 10 0 0 10 11 9 0 10 10 0 0 0 0 0 0 0 4 16 
16 3 10 9 0 10 0 0 0 0 10 0 0 9 0 0 0 0 10 10 0 0 0 0 9 9 9 0 0 0 10 0 9 0 0 0 9 9 10 0 0 0 0 9 9 0 0 0 0 0 0 9 10 9 0 0 9 9 0 9 0 0 9 11 0 0 0 0 0 0 0 0 0 10 0 10 0 9 0 0 10 12 0 10 0 12 9 9 0 9 0 9 0 0 0 12 9 9 0 9 4 16 
16 7 2 2 2 2 2 2 2 2 2 2 2 2 2 2 2 2 2 2 2 2 2 2 2 2 2 2 2 2 2 2 2 2 2 2 2 2 2 2 2 2 2 2 2 2 2 2 2 2 2 2 2 2 2 2 2 2 2 2 2 2 2 2 2 2 2 2 2 2 2 2 2 2 2 2 2 2 2 2 2 2 2 2 2 2 2 2 2 2 2 2 2 2 2 2 2 2 2 2 8 16 
19 15 15 15 15 15 15 15 15 15 15 15 15 15 15 15 15 15 15 15 15 15 15 15 15 15 15 15 15 15 15 15 15 15 15 15 15 15 15 15 15 15 15 15 15 15 15 15 15 15 15 15 15 15 15 15 15 15 15 15 15 15 15 15 15 15 15 15 15 15 15 15 15 15 15 15 15 15 15 15 15 15 15 15 15 15 15 15 15 15 15 15 15 15 15 15 15 15 15 15 15 20 
